min -5
max 10
start 1 1
img 1 Wall2.png
img 2 Stone2.png
img 3 Fire1.png
img 4 Spikes.png
img 5 Poop.png
img 6 key.png
img 7 lock.png
img 8 stairs.png
map
2,2,0,1  2,2,0,1  2,2,0,1  0,2,0,0  0,2,-6,0  0,2,1,0  0,2,-10,0  0,2,0,0  1,2,15,5  3,2,20,6  
2,2,0,1  0,2,0,0  0,2,2,0  0,2,-2,0  0,2,7,0  2,2,0,1  0,2,-6,0  0,2,-6,0  1,2,15,5  1,2,15,5  
2,2,0,1  0,2,?,0  2,2,0,1  0,2,-1,0  0,2,-5,0  0,2,-10,0  0,2,-10,0  0,2,5,0  0,2,7,0  0,2,-1,0  
0,2,6,0  0,2,-5,0  0,2,-2,0  0,2,2,0  0,2,4,0  0,2,-9,0  0,2,-9,0  0,2,-6,0  0,2,-10,0  0,2,7,0  
0,2,5,0  0,2,8,0  2,2,0,1  2,2,0,1  2,2,0,1  2,2,0,1  2,2,0,1  0,2,9,0  0,2,6,0  0,2,-3,0  
0,2,-5,0  0,2,-3,0  2,2,0,1  0,2,-8,0  0,2,-1,0  0,2,-3,0  2,2,0,1  0,2,-7,0  2,2,0,1  0,2,-6,0  
0,2,-5,0  0,2,-1,0  2,2,0,1  0,2,-3,0  5,2,0,8  0,2,-1,0  2,2,0,1  0,2,-9,0  0,2,9,0  0,2,7,0  
1,2,-15,3  1,2,-15,3  2,2,0,1  0,2,2,0  0,2,-2,0  0,2,7,0  2,2,0,1  0,2,9,0  2,2,0,1  0,2,8,0  
1,2,-15,3  1,2,-15,3  2,2,0,1  2,2,0,1  4,2,0,7  2,2,0,1  2,2,0,1  0,2,-10,0  0,2,3,0  0,2,-2,0  
0,2,0,0  0,2,5,0  0,2,0,0  0,2,-7,0  0,2,2,0  0,2,-3,0  0,2,-9,0  0,2,9,0  0,2,8,0  0,2,-2,0  
2,2,0,1  0,2,-10,0  0,2,-8,0  0,2,5,0  0,2,0,0  0,2,10,0  0,2,-8,0  0,2,1,0  0,2,-6,0  2,2,0,1  
2,2,0,1  2,2,0,1  2,2,0,1  2,2,0,1  2,2,0,1  2,2,0,1  2,2,0,1  2,2,0,1  2,2,0,1  2,2,0,1  
